12 21 2
Galley
001 001 001 001 001 001 001 001 001 001 001 001
001 001 001 001 001 001 001 001 001 001 001 001
001 001 001 001 001 001 001 001 020 020 001 001
001 020 020 020 020 020 020 161 020 020 020 001
001 020 020 020 020 020 020 161 020 020 020 001
001 020 020 020 020 020 020 161 020 020 020 001
001 020 020 020 020 020 020 161 020 020 020 001
001 020 020 020 020 020 020 161 020 020 020 001
001 020 020 020 020 020 020 161 020 020 020 001
001 020 020 020 020 020 020 020 020 020 020 001
001 020 020 020 020 020 020 020 020 020 020 001
001 020 020 020 020 020 020 020 020 020 020 001
001 020 020 020 020 020 020 020 020 020 020 001
001 020 020 020 020 020 020 020 020 020 020 020
001 020 020 020 020 020 020 020 020 020 020 001
001 020 020 020 020 020 020 020 020 020 020 001
001 020 020 020 020 020 020 020 020 020 020 001
001 020 020 020 161 020 020 161 020 020 020 001
001 020 020 020 161 020 020 020 020 020 020 001
001 001 001 001 001 020 020 001 001 001 001 001
001 001 001 001 001 001 001 001 001 001 001 001
001 001 001 001 001 001 001 001 001 001 001 001

#000
100;
0;
0;
0;
0;
*0
#001
081;
0;
0;
0;
1;
*0
-Overslept again?;
