12 21 2
001 001 001 001 001 001 001 001 001 001 001 001
001 001 001 001 001 001 001 001 001 001 001 001
001 001 001 001 001 001 001 001 02201001 02201001 001 001
001 020 020 020 020 020 020 161 020 020 020 001
001 020 020 020 020 020 020 161 020 020 020 001
001 020 020 020 020 020 020 161 020 020 020 001
001 020 020 020 020 020 020 161 020 020 020 001
001 020 020 020 020 020 020 161 020 020 020 001
001 020 020 020 020 020 020 161 020 020 020 001
001 020 020 020 020 020 020 020 020 020 020 001
001 020 020 020 020 020 020 020 020 020 020 001
001 020 020 020 020 020 020 020 020 020 020 001
001 020o001 020 020 020 020 020 020 020 020 020 001
001 020 020 020 020 020 020 020 020 020 020 02203001
001 020 020 020 020 020 020 020 020 020 020 001
001 020 020 020 020 020 020 020 020 020 020 001
001 020 020 020 020 020 020 020 020 020 020 001
001 020 020 020 161 020 020 161 020 020 020 001
001 020 020 020 161 020 020x000 020 020 020 020 001
001 001 001 001 001 02204232 02204233 001 001 001 001 001
001 001 001 001 001 001 001 001 001 001 001 001
001 001 001 001 001 001 001 001 001 001 001 001

#001
2;
0;
*0
-Sorry Foo, not right now. I've got a ton of provisioning to do.;
-Ok, so... truffle oil. Where is the truffle oil.;
*1
-Ok, so...truffle oil. Where is the truffle oil.;
*2
-Ok, so... truffle oil. Where is the truffle oil.;
