12 21 4
Galley
001 001 001 001 001 001 001 001 001 001 001 001
001 001 001 001 001 001 001 001 001 001 001 001
001 001 001 001 001 001 001 001 020 020 001 001
001 020 020 020 020 020 020 161 020 020 020 001
001 020 020 020 020 020 020 161 020 020 020 001
001 020 020 020 020 020 020 161 020 020 020 001
001 020 020 020 020 020 020 161 020 020 020 001
001 020 020 020 020 020 020 161 020 020 020 001
001 020 020 020 020 020 020 161 020 020 020 001
001 020 020 020 020 020 020 020 020 020 020 001
001 020 020 020 020 020 020 020 020 020 020 001
001 020 020 020 020 020 020 020 020 020 020 001
001 020 020 020 020 020 020 020 020 020 020 001
001 020 020 020 020 020 020 020 020 020 020 020
001 020 020 020 020 020 020 020 020 020 020 001
001 020 020 020 020 020 020 020 020 020 020 001
001 020 020 020 020 020 020 020 020 020 020 001
001 020 020 020 161 020 020 161 020 020 020 001
001 020 020 020 161 020 020 020 020 020 020 001
001 001 001 001 001 020 020 001 001 001 001 001
001 001 001 001 001 020 020 001 001 001 001 001
001 001 001 001 001 001 001 001 001 001 001 001

#000
200;
0;
0;
0;
0;
*0
#001
081;
0;
0;
0;
1;
*0
-Overslept again?;
#002
032;
5;
0;
0;
0;
*0
@01.209;
*1
@01.209;
*2
@01.209;
#003
033;
5;
0;
0;
0;
*0
@01.210;
*1
@01.210;
*2
@01.210;
