12 21 1
@1 @1 @1 @1 @1 @1 @1 @1 @1 @1 @1 @1
@1 @1 @1 @1 @1 @1 @1 @1 @1 @1 @1 @1
@1 @1 @1 @1 @1 @1 @1 @1 @1 @1 @1 @1
@1 .0 .0 .0 .0 .0 .0 .0 .0 .0 .0 @1
@1 .0 .0 .0 .0 .0 .0 .0 .0 .0 .0 @1
@1 .0 .0 .0 .0 .0 .0 .0 .0 .0 .0 @1
@1 .0 .0 .0 .0 .0 .0 .0 .0 .0 .0 @1
@1 .0 .0 .0 .0 .0 .0 .0 .0 .0 .0 @1
@1 .0 .0 .0 .0 .0 .0 .0 .0 .0 .0 @1
@1 .0 .0 .0 .0 .0 .0 .0 .0 .0 .0 @1
@1 .0 .0 .0 .0 .0 .0 .0 .0 .0 .0 @1
@1 .0 .0 .0 .0 .0 .0 .0 .0 .0 .0 @1
@1 .0 .0 .0 .0 .0 .0 .0 .0 .0 .0 @1
@1 $1 $1 $1 $1 .0 .0 $1 $1 $1 $1 @1
@1 .0 .0 .0 $1 .0 .0 $1 .0 .0 .0 @1
@1 .0 .0 .0 $1 .0 .0 $1 .0 .0 .0 @1
@1 .0 .0 .0 .0 .0 .0 .0 .0 .0 .0 @1
@1 .0 .0 .0 $1 .0 .0 $1 .0 .0 .0 @1
@1 .0 .0 .0 $1 .0 .0x000 $1 .0 .0 .0 @1
@1 @1 @1 @1 @1 @204 @1 @1 @1 @1 @1 @1
@1 @1 @1 @1 @1 @1 @1 @1 @1 @1 @1 @1
@1 @1 @1 @1 @1 @1 @1 @1 @1 @1 @1 @1
