12 21 8
Galley
001 001 001 001 001 001 001 001 001 001 001 001
001 001 001 001 001 001 001 001 001 001 001 001
001 001 001 001 001 001 001 001 020 020 001 001
001 020 020 020 020 020 020 161 020 020 020 001
001 020 020 020 020 020 020 161 020 020 020 001
001 020 020 020 020 020 020 161 020 020 020 001
001 020 020 020 020 020 020 161 020 020 020 001
001 020 020 020 020 020 020 161 020 020 020 001
001 020 020 020 020 020 020 161 020 020 020 001
001 020 020 020 020 020 020 020 020 020 020 001
001 020 020 020 020 020 020 020 020 020 020 001
001 020 020 020 020 020 020 020 020 020 020 001
001 020 020 020 020 020 020 020 020 020 020 001
001 020 020 020 020 020 020 020 020 020 020 020
001 020 020 020 020 020 020 020 020 020 020 001
001 020 020 020 020 020 020 020 020 020 020 001
001 020 020 020 020 020 020 020 020 020 020 001
001 020 020 020 161 020 020 161 020 020 020 001
001 020 020 020 161 020 020 020 020 020 020 001
001 001 001 001 001 020 020 001 001 001 001 001
001 001 001 001 001 020 020 001 001 001 001 001
001 001 001 001 001 001 001 001 001 001 001 001

#000
0;
0;
0;
0;
0;
*0
#001
081;
0;
0;
0;
1;
*0
-Overslept again?;
#002
033;
5;
0;
0;
0;
*0;
@01.220;
#003
034;
5;
0;
0;
0;
*0;
@01.221;
#004
232;
5;
0;
0;
0;
*0;
@04.220;
#005
233;
5;
0;
0;
0;
*0;
@04.221;
