12 21 2
001 001 001 001 001 001 001 001 001 001 001 001
001 001 001 001 001 001 001 001 001 001 001 001
001 001 001 001 001 001 001 001 02201 02201 001 001
001 020 020 020 020 020 020 161 020 020 020 001
001 020 020 020 020 020 020 161 020 020 020 001
001 020 020 020 020 020 020 161 020 020 020 001
001 020 020 020 020 020 020 161 020 020 020 001
001 020 020 020 020 020 020 161 020 020 020 001
001 020 020 020 020 020 020 161 020 020 020 001
001 020 020 020 020 020 020 020 020 020 020 001
001 020 020 020 020 020 020 020 020 020 020 001
001 020 020 020 020 020 020 020 020 020 020 001
001 020o001 020 020 020 020 020 020 020 020 020 001
001 020 020 020 020 020 020 020 020 020 020 02203
001 020 020 020 020 020 020 020 020 020 020 001
001 020 020 020 020 020 020 020 020 020 020 001
001 020 020 020 020 020 020 020 020 020 020 001
001 020 020 020 161 020 020 161 020 020 020 001
001 020 020 020 161 020 020x000 020 020 020 020 001
001 001 001 001 001 02204 02204 001 001 001 001 001
001 001 001 001 001 001 001 001 001 001 001 001
001 001 001 001 001 001 001 001 001 001 001 001

#001
0;
0;
*0
-Sorry Foo, not right now. I've got a ton of provisioning to do.;
-Ok, so... truffle oil. Where is the truffle oil.;
*1
-Ok, so...truffle oil. Where is the truffle oil.;
*2
-Ok, so... truffle oil. Where is the truffle oil.;
